20 20
11111111111111111111
10000000000000000001
10000000000000000001
10000000000000000001
10000000111111000001
10000000100001000001
10000000100001000001
10000000100001000001
10000000100001000001
10000000S00001000001
10000000100001000001
10000000100001000001
10000000111111000001
10000000000000000001
10001101110000000001
10001000010000000001
10001000011111100001
10001000011111100001
10001000011111100001
11111111111111111111
